    int[][] L1 = {{3,0,1,0,1},{0,2,0,1,0},{1,0,1,0,1},{0,1,0,1,0},{1,0,1,0,1}};
    int[][] L2 = {{1,0,1,0,3},{0,1,0,1,0},{1,0,1,0,2},{0,1,0,1,0},{1,0,1,0,1}};
    int[][] L3 = {{1,0,1,0,1},{0,1,0,2,0},{1,0,3,0,1},{0,1,0,1,0},{1,0,1,0,1}};
    int[][] L4 = {{3,0,1,0,1},{0,2,0,1,0},{1,0,1,0,1},{0,1,0,2,0},{1,0,1,0,1}};
    int[][] L5 = {{1,0,2,0,1},{0,1,0,1,0},{2,0,1,0,1},{0,1,0,1,0},{3,0,1,0,1}};

    int[][] L6 = {{1,0,1,0,1},{0,1,0,1,0},{1,0,2,0,3},{0,2,0,2,0},{1,0,1,0,1}};
    int[][] L7 = {{1,0,2,0,3},{0,1,0,1,0},{2,0,1,0,2},{0,1,0,1,0},{1,0,2,0,1}};
    int[][] L8 = {{1,0,3,0,1},{0,2,0,2,0},{1,0,1,0,1},{0,2,0,2,0},{1,0,1,0,1}};
    int[][] L9 = {{1,0,2,0,1},{0,2,0,2,0},{1,0,3,0,2},{0,1,0,2,0},{1,0,1,0,1}};
    int[][] L10 = {{1,0,2,0,1},{0,1,0,2,0},{2,0,1,0,1},{0,2,0,2,0},{1,0,1,0,3}};

	DONE^^^

    int[][] L11 = {{1,0,1,0,1},{0,1,0,1,0},{1,0,1,0,1},{0,1,0,1,0},{1,0,1,0,1}};
    int[][] L12 = {{1,0,1,0,1},{0,1,0,1,0},{1,0,1,0,1},{0,1,0,1,0},{1,0,1,0,1}};
    int[][] L13 = {{1,0,1,0,1},{0,1,0,1,0},{1,0,1,0,1},{0,1,0,1,0},{1,0,1,0,1}};
    int[][] L14 = {{1,0,1,0,1},{0,1,0,1,0},{1,0,1,0,1},{0,1,0,1,0},{1,0,1,0,1}};
    int[][] L15 = {{1,0,1,0,1},{0,1,0,1,0},{1,0,1,0,1},{0,1,0,1,0},{1,0,1,0,1}};

    int[][] L16 = {{1,0,1,0,1},{0,1,0,1,0},{1,0,1,0,1},{0,1,0,1,0},{1,0,1,0,1}};
    int[][] L17 = {{1,0,1,0,1},{0,1,0,1,0},{1,0,1,0,1},{0,1,0,1,0},{1,0,1,0,1}};
    int[][] L18 = {{1,0,1,0,1},{0,1,0,1,0},{1,0,1,0,1},{0,1,0,1,0},{1,0,1,0,1}};
    int[][] L19 = {{1,0,1,0,1},{0,1,0,1,0},{1,0,1,0,1},{0,1,0,1,0},{1,0,1,0,1}};
    int[][] L20 = {{1,0,1,0,1},{0,1,0,1,0},{1,0,1,0,1},{0,1,0,1,0},{1,0,1,0,1}};

    int[][] L21 = {{1,0,1,0,1},{0,1,0,1,0},{1,0,1,0,1},{0,1,0,1,0},{1,0,1,0,1}};
    int[][] L22 = {{1,0,1,0,1},{0,1,0,1,0},{1,0,1,0,1},{0,1,0,1,0},{1,0,1,0,1}};
    int[][] L23 = {{1,0,1,0,1},{0,1,0,1,0},{1,0,1,0,1},{0,1,0,1,0},{1,0,1,0,1}};
    int[][] L24 = {{1,0,1,0,1},{0,1,0,1,0},{1,0,1,0,1},{0,1,0,1,0},{1,0,1,0,1}};
    int[][] L25 = {{1,0,1,0,1},{0,1,0,1,0},{1,0,1,0,1},{0,1,0,1,0},{1,0,1,0,1}};

    int[][] L26 = {{1,0,1,0,1},{0,1,0,1,0},{1,0,1,0,1},{0,1,0,1,0},{1,0,1,0,1}};
    int[][] L27 = {{1,0,1,0,1},{0,1,0,1,0},{1,0,1,0,1},{0,1,0,1,0},{1,0,1,0,1}};
    int[][] L28 = {{1,0,1,0,1},{0,1,0,1,0},{1,0,1,0,1},{0,1,0,1,0},{1,0,1,0,1}};
    int[][] L29 = {{1,0,1,0,1},{0,1,0,1,0},{1,0,1,0,1},{0,1,0,1,0},{1,0,1,0,1}};
    int[][] L30 = {{1,0,1,0,1},{0,1,0,1,0},{1,0,1,0,1},{0,1,0,1,0},{1,0,1,0,1}};

    int[][] L31 = {{1,0,1,0,1},{0,1,0,1,0},{1,0,1,0,1},{0,1,0,1,0},{1,0,1,0,1}};
    int[][] L32 = {{1,0,1,0,1},{0,1,0,1,0},{1,0,1,0,1},{0,1,0,1,0},{1,0,1,0,1}};
    int[][] L33 = {{1,0,1,0,1},{0,1,0,1,0},{1,0,1,0,1},{0,1,0,1,0},{1,0,1,0,1}};
    int[][] L34 = {{1,0,1,0,1},{0,1,0,1,0},{1,0,1,0,1},{0,1,0,1,0},{1,0,1,0,1}};
    int[][] L35 = {{1,0,1,0,1},{0,1,0,1,0},{1,0,1,0,1},{0,1,0,1,0},{1,0,1,0,1}};

    int[][] L36 = {{1,0,1,0,1},{0,1,0,1,0},{1,0,1,0,1},{0,1,0,1,0},{1,0,1,0,1}};
    int[][] L37 = {{1,0,1,0,1},{0,1,0,1,0},{1,0,1,0,1},{0,1,0,1,0},{1,0,1,0,1}};
    int[][] L38 = {{1,0,1,0,1},{0,1,0,1,0},{1,0,1,0,1},{0,1,0,1,0},{1,0,1,0,1}};
    int[][] L39 = {{1,0,1,0,1},{0,1,0,1,0},{1,0,1,0,1},{0,1,0,1,0},{1,0,1,0,1}};
    int[][] L40 = {{1,0,1,0,1},{0,1,0,1,0},{1,0,1,0,1},{0,1,0,1,0},{1,0,1,0,1}};


